Hon Tony Abbott: Member for Warringah, New South Wales
Hon Anthony Albanese: Member for Grayndler, New South Wales
Mr John Alexander OAM: Member for Bennelong, New South Wales
Hon Karen Andrews: Member for McPherson, Queensland
Hon Kevin Andrews: Member for Menzies, Victoria
Mr Adam Bandt: Member for Melbourne, Victoria
Ms Julia Banks: Member for Chisholm, Victoria
Hon Sharon Bird: Member for Cunningham, New South Wales
Hon Julie Bishop: Member for Curtin, Western Australia
Hon Chris Bowen: Member for McMahon, New South Wales
Mr Andrew Broad: Member for Mallee, Victoria
Mr Russell Broadbent: Member for McMillan, Victoria
Ms Gai Brodtmann: Member for Canberra, Australian Capital Territory
Mr Scott Buchholz: Member for Wright, Queensland
Hon Tony Burke: Member for Watson, New South Wales
Hon Linda Burney: Member for Barton, New South Wales
Hon Mark Butler: Member for Port Adelaide, South Australia
Ms Terri Butler: Member for Griffith, Queensland
Hon Anthony Byrne: Member for Holt, Victoria
Dr Jim Chalmers: Member for Rankin, Queensland
Mr Nick Champion: Member for Wakefield, South Australia
Hon Darren Chester: Member for Gippsland, Victoria
Ms Lisa Chesters: Member for Bendigo, Victoria
Mr George Christensen: Member for Dawson, Queensland
Hon Steven Ciobo: Member for Moncrieff, Queensland
Hon Jason Clare: Member for Blaxland, New South Wales
Ms Sharon Claydon: Member for Newcastle, New South Wales
Mr David Coleman: Member for Banks, New South Wales
Hon Julie Collins: Member for Franklin, Tasmania
Mr Pat Conroy: Member for Charlton, New South Wales
Mr Mark Coulton: Member for Parkes, New South Wales
Mr Chris Crewther: Member for Dunkley, Victoria
Hon Michael Danby: Member for Melbourne Ports, Victoria
Mr Milton Dick: Member for Oxley, Queensland
Hon Mark Dreyfus QC: Member for Isaacs, Victoria
Hon Peter Dutton: Member for Dickson, Queensland
Hon Justine Elliot: Member for Richmond, New South Wales
Hon Kate Ellis: Member for Adelaide, South Australia
Hon Warren Entsch: Member for Leichhardt, Queensland
Mr Trevor Evans: Member for Brisbane, Queensland
Mr Jason Falinski: Member for Mackellar, New South Wales
Hon David Feeney: Member for Batman, Victoria
Hon Joel Fitzgibbon: Member for Hunter, New South Wales
Hon Paul Fletcher: Member for Bradfield, New South Wales
Mr Mike Freelander: Member for Macarthur, New South Wales
Hon Josh Frydenberg: Member for Kooyong, Victoria
Mr Andrew Gee: Member for Calare, New South Wales
Mr Steve Georganas: Member for Hindmarsh, South Australia
Mr Andrew Giles: Member for Scullin, Victoria
The Hon Dr David Gillespie: Member for Lyne, New South Wales
Mr Ian Goodenough: Member for Moore, Western Australia
Mr Luke Gosling: Member for Solomon, Northern Territory
Mr Tim Hammond: Member for Perth, Western Australia
Mr Ross Hart: Member for Bass, Tasmania
Hon Luke Hartsuyker: Member for Cowper, New South Wales
Mr Andrew Hastie: Member for Canning, Western Australia
Hon Alex Hawke: Member for Mitchell, New South Wales
Mr Chris Hayes: Member for Fowler, New South Wales
Ms Sarah Henderson: Member for Corangamite, Victoria
Mr Julian Hill: Member for Bruce, Victoria
Mr Kevin Hogan: Member for Page, New South Wales
Mr Luke Howarth: Member for Petrie, Queensland
Hon Greg Hunt: Member for Flinders, Victoria
Hon Ed Husic: Member for Chifley, New South Wales
Mr Steve Irons: Member for Swan, Western Australia
Mr Ewen Jones: Member for Herbert, Queensland
Mr Stephen Jones: Member for Throsby, New South Wales
Hon Barnaby Joyce: Member for New England, New South Wales
Hon Bob Katter: Member for Kennedy, Queensland
Ms Justine Keay: Member for Braddon, Tasmania
Hon Michael Keenan: Member for Stirling, Western Australia
Mr Craig Kelly: Member for Hughes, New South Wales
The Hon Dr Mike Kelly AM: Member for Eden-Monaro, New South Wales
Mr Matt Keogh: Member for Burt, Western Australia
Mr Peter Khalil: Member for Wills, Victoria
Hon Catherine King: Member for Ballarat, Victoria
Ms Madeleine King: Member for Brand, Western Australia
Ms Susan Lamb: Member for Longman, Queensland
Mr Andrew Laming: Member for Bowman, Queensland
Ms Michelle Landry: Member for Capricornia, Queensland
Hon Craig Laundy: Member for Reid, New South Wales
Mr Julian Leeser: Member for Berowra, New South Wales
Hon Dr Andrew Leigh: Member for Fenner, Australian Capital Territory
Hon Sussan Ley: Member for Farrer, New South Wales
Hon Jenny Macklin: Member for Jagajaga, Victoria
Ms Nola Marino: Member for Forrest, Western Australia
Hon Richard Marles: Member for Corio, Victoria
Ms Emma McBride: Member for Dobell, New South Wales
Hon Michael McCormack: Member for Riverina, New South Wales
Ms Cathy McGowan AO: Member for Indi, Victoria
Dr John McVeigh: Member for Groom, Queensland
Mr Brian Mitchell: Member for Lyons, Tasmania
Mr Rob Mitchell: Member for McEwen, Victoria
Hon Scott Morrison: Member for Cook, New South Wales
Mr Ben Morton: Member for Tangney, Western Australia
Hon Shayne Neumann: Member for Blair, Queensland
Mr Ted O'Brien: Member for Fairfax, Queensland
Mr Llew O'Brien: Member for Wide Bay, Queensland
Hon Brendan O'Connor: Member for Gorton, Victoria
Mr Ken O'Dowd: Member for Flynn, Queensland
Hon Kelly O'Dwyer: Member for Higgins, Victoria
Ms Clare O'Neil: Member for Hotham, Victoria
Ms Julie Owens: Member for Parramatta, New South Wales
Mr Tony Pasin: Member for Barker, South Australia
Mr Graham Perrett: Member for Moreton, Queensland
Hon Keith Pitt: Member for Hinkler, Queensland
Hon Tanya Plibersek: Member for Sydney, New South Wales
Hon Christian Porter: Member for Pearce, Western Australia
Hon Jane Prentice: Member for Ryan, Queensland
Ms Melissa Price: Member for Durack, Western Australia
Hon Christopher Pyne: Member for Sturt, South Australia
Mr Rowan Ramsey: Member for Grey, South Australia
Hon Amanda Rishworth: Member for Kingston, South Australia
Hon Stuart Robert: Member for Fadden, Queensland
Ms Michelle Rowland: Member for Greenway, New South Wales
Ms Joanne Ryan: Member for Lalor, Victoria
Ms Rebekha Sharkie: Member for Mayo, South Australia
Hon Bill Shorten: Member for Maribyrnong, Victoria
The Hon Tony Smith: Member for Casey, Victoria
Hon Warren Snowdon: Member for Lingiari, Northern Territory
Ms Anne Stanley: Member for Werriwa, New South Wales
Mrs Ann Sudmalis: Member for Gilmore, New South Wales
Mr Michael Sukkar: Member for Deakin, Victoria
Hon Wayne Swan: Member for Lilley, Queensland
Ms Meryl Swanson: Member for Paterson, New South Wales
Hon Angus Taylor: Member for Hume, New South Wales
Hon Dan Tehan: Member for Wannon, Victoria
Ms Susan Templeman: Member for Macquarie, New South Wales
Hon Matt Thistlethwaite: Member for Kingsford Smith, New South Wales
Hon Alan Tudge: Member for Aston, Victoria
Hon Malcolm Turnbull: Member for Wentworth, New South Wales
Ms Maria Vamvakinou: Member for Calwell, Victoria
Mr Bert van Manen: Member for Forde, Queensland
Mr Ross Vasta: Member for Bonner, Queensland
Mr Andrew Wallace: Member for Fisher, Queensland
Mr Tim Watts: Member for Gellibrand, Victoria
Mrs Lucy Wicks: Member for Robertson, New South Wales
Mr Andrew Wilkie: Member for Denison, Tasmania
Mr Josh Wilson: Member for Fremantle, Western Australia
Mr Rick Wilson: Member for O'Connor, Western Australia
Mr Tim Wilson: Member for Goldstein, Victoria
Mr Jason Wood: Member for La Trobe, Victoria
Hon Ken Wyatt AM: Member for Hasluck, Western Australia
Mr Tony Zappia: Member for Makin, South Australia
Mr Trent Zimmerman: Member for North Sydney, New South Wales
